# 格式为日文[Tab]中文[Tab]解释(可不写)，参考项目wiki

# 语义标注

[title]	[title]	场景标题标记，请保留，标记的该行文本是整个场景（后续对话）的标题，非角色对话或旁白
[select]	[select]	选项文本标记，请保留，标记的该行是玩家可选择的选项条目，非角色对话或旁白，通常出现在分支节点处

# 角色

真一	真一	人名，男性，全名"鹿岛真一"（鹿島 真一，かしま しんいち），本作主人公，21岁，大学生，随和但爱吐槽，有点优柔寡断，但关键时刻会行动，与希有婚约，紫的后辈
シンちゃん	小真	人名，男性，对真一的爱称
真一さん	真一先生	人名，男性，对真一的称呼
真一くん	真一君	人名，男性，对真一的称呼
鹿島真一	鹿岛真一	人名全名，男性，即"真一"
鹿島	鹿岛	人名姓氏，真一的姓氏

瑞穂	瑞穗	人名，女性，全名"岛崎瑞穗"（島崎 瑞穂，しまざき みずほ），19岁，社会人，东京某设计公司职员，表面冷淡傲娇，实则内心温柔；对安芸有强烈的保护欲，樱的妹妹，与安芸是高中三年同班同学
瑞穂ちゃん	小瑞穗	人名，女性，对瑞穗的称呼
瑞穂さん	瑞穗小姐	人名，女性，对瑞穗的称呼
島崎瑞穂	岛崎瑞穗	人名全名，女性，即"瑞穗"

櫻	樱	人名，女性，全名"岛崎樱"（島崎 櫻，しまざき さくら），已故（幽灵），瑞穂的姐姐，嘉悦的恋人，被日向谋杀，后化为幽灵；执着于嘉悦，因爱生恨，执念极强，对真一（误认为嘉悦转世）有扭曲的爱意
櫻さん	樱小姐	人名，女性，对樱的称呼
島崎櫻	岛崎樱	人名全名，女性，即"樱"

島崎	岛崎	人名姓氏，瑞穗和樱的姓氏


ユカリ	紫	人名，女性，全名"冲紫"（沖 ユカリ，おき ゆかり），22岁，大学生，强势、爱喝酒（酒品差）、有S倾向，但在嘉悦面前会变得极度害羞乖巧，嘉悦的大学后辈，真一和希的前辈
ユカリさん	紫小姐	人名，女性，对紫的称呼
沖ユカリ	冲紫	人名全名，女性，即"紫"
沖	冲	人名姓氏，紫的姓氏
沖紫	冲紫	人名全名，女性，即"紫"

希	希	人名，女性，全名"白坂希"（白坂 希，しらさか のぞみ），19岁，大学生，白坂集团总裁的末女儿，极度活泼直率，任性但专一，嫉妒心极强，酒品极差，与真一有婚约
希ちゃん	小希	人名，女性，对希的称呼
希さん	希小姐	人名，女性，对希的称呼
白坂希	白坂希	人名全名，女性，即"希"
白坂	白坂	人名姓氏，希的姓氏

安芸	安芸	人名，女性，全名"三仓安芸"（三倉 安芸，みくら あき），19岁，川澄亭老板娘的女儿，旅馆工作人员，温柔内向，极度自卑，习惯性道歉，患有支气管哮喘，与瑞穂是高中同班兼亲友，曾被日向性侵
安芸ちゃん	小安芸	人名，女性，安芸的称呼
三倉安芸	三仓安芸	人名全名，女性，即"安芸"
三倉	三仓	人名姓氏，安芸的姓氏

トキ子	时子	人名，女性，全名"片濑时子"（片瀬 トキ子），大学生，紫的亲友，摄影部成员，说话有气无力，节奏独特
トキ子さん	时子小姐	人名，女性，对时子的称呼
片瀬トキ子	片濑时子	人名全名，女性

朝霧	朝雾	人名，女性，全名"朝雾顺子"（朝霧 順子），地方名士之女，嘉悦的秘书，杀害日向的真凶
朝霧さん	朝雾小姐	人名，女性，对朝雾的称呼
順子さん	顺子小姐	人名，女性，对朝雾的称呼
順子	顺子	人名，女性，朝雾的名字

水鳥	水鸟	人名，女性，全名"逢濑水鸟"（逢瀬 水鳥），年轻女子，民艺品店店主，神秘、柔和、知识渊博，说话常带深意
水鳥さん	水鸟小姐	人名，女性，对水鸟的称呼

嘉悦	嘉悦	人名，男性，全名"嘉悦行雄"（嘉悦 行雄），媛乃泽铁路公司职员，名门子弟，温和有礼，紫的大学前辈，樱的恋人
嘉悦さん	嘉悦先生	人名，男性，对嘉悦的称呼
行雄さん	行雄先生	人名，男性，对嘉悦的称呼
嘉悦行雄	嘉悦行雄	人名全名，男性，即"嘉悦"

日向	日向	人名，男性，全名"日向彻"（日向 徹），已故，川澄亭厨师，暴力、控制欲强、偏执，性侵安芸，谋杀樱，后被朝雾谋杀
日向さん	日向先生	人名，男性，对日向的称呼
徹さん	彻先生	人名，男性，对日向的称呼

女将	老板娘	人名称呼，女性，旅馆老板娘

# 其他

来世結び	来世结缘	地方信仰，关于来世结缘的传说
儀式	仪式	特殊名词
媛乃澤	媛乃泽	地名/站名/铁路公司名称
川澄亭	川澄亭	建筑/旅馆名称
清水トンネル	清水隧道	地名/建筑物
高梨山駅	高梨山站	地名，车站名
バートラム	巴特拉姆	品牌名
アナウンス	广播	车站广播
藤橋	藤桥	地名/站名
